NO ./textures/wood_north.xpm
SO ./textures/wood_south.xpm
WE ./textures/brick_west.xpm
EA ./textures/stone_east.xpm

F 100,100,100
C 200,200,255

1111111111
1000000001
1000N00001
1000000001
1111111111
