NO ./textures/wood_north.xpm
SO ./textures/wood_south.xpm
WE ./textures/brick_west.xpm
EA ./textures/stone_east.xpm

F 50,50,50
C 100,100,150

1111111111111111111
1000000000000000001
1011111111111111101
1000000000000000001
1011111111111111101
1000000N00000000001
1011111111111111101
1000000000000000001
1111111111111111111
