NO ./textures/wood_north.xpm
SO ./textures/wood_south.xpm
WE ./textures/brick_west.xpm
EA ./textures/stone_east.xpm

F 139,69,19
C 135,206,235

        111111111
        100000001
        100000001
111111111000000001
100000000000000001
100000000N00000001
100000000000000001
111111111000000001
        100000001
        100000001
        111111111
