NO ./textures/wood_north.xpm
SO ./textures/wood_south.xpm
WE ./textures/brick_west.xpm
EA ./textures/stone_east.xpm

F 70,70,70
C 150,180,220

11111111111111111
10000000001000001
10111111101011101
10100000001000101
10101111111110101
10100000000010101
10111111111010101
10000000000010101
11111111111010101
10000001010010101
10111101010010101
10100101010010101
10101101010010101
10101N00000000101
10101110111111101
10000000100000001
11111111111111111
