NO ./textures/wood_north.xpm
SO ./textures/wood_south.xpm
WE ./textures/brick_west.xpm
EA ./textures/stone_east.xpm

F 80,60,40
C 180,220,255

11111111111111
10000000000001
10000000000001
10000000000001
10000N00000001
10000000000001
10000000000001
10000000000001
11111111111111
