NO             ./textures/north.xpm

SO ./textures/south.xpm
WE ./textures/west.xpm
EA ./textures/east.xpm


F                 58, 95, 11


C 11, 31, 58



11111111111
10001100011
10001100011
10001100011
10001100011
10N00000001
10000000001
10000000001
10000100001
10000000001
11111000001
11111111111