NO ./textures/north.xpm
SO ./textures/south.xpm
WE ./textures/west.xpm
EA ./textures/east.xpm

F 80,80,80
C 135,206,235

111111111111111111111111111111111111111111111111111111111111111111111111111111111111111111111111111111111111111111
100000000000000000000000000000000000000000000000000000000000000000000000000000000000000000000000000000000000001
100000000000000000000000000000000000000000000000000000000000000000000000000000000000000000000000000000000000001
100000000000000000000000000000000000000000000000000000000000000000000000000000000000000000000000000000000000001
100111111111111111111111111111111111111111111111111111111111111111111111111111111111111111111111111111111110001
100100000000000000000000000000000000000000000000000000000000000000000000000000000000000000000000000000000010001
100100000000000000000000000000000000000000000000000000000000000000000000000000000000000000000000000000000010001
100100011111111111111111111111111111111111111111111111111111111111111111111111111111111111111111111111100010001
100100010000000000000000000000000000000000000000000000000000000000000000000000000000000000000000000000100010001
100100010000000000000000000000000000000000000000000000000000000000000000000000000000000000000000000000100010001
100100010001111111111111111111111111111111111111111111111111111111111111111111111111111111111111111000100010001
100100010001000000000000000000000000000000000000000000000000000000000000000000000000000000000000001000100010001
100100010001000000000000000000000000000000000000000000000000000000000000000000000000000000000000001000100010001
100100010001000111111111111111111111111111111111111111111111111111111111111111111111111111111100001000100010001
100100010001000100000000000000000000000000000000000000000000000000000000000000000000000000000100001000100010001
100100010001000100000000000000000000000000000000000000000000000000000000000000000000000000000100001000100010001
100100010001000100011111111111111111111111111111111111111111111111111111111111111111111111000100001000100010001
100100010001000100010000000000000000000000000000000000000000000000000000000000000000000010000100001000100010001
100100010001000100010000000000000000000000000000000000000000000000000000000000000000000010000100001000100010001
100100010001000100010001111111111111111111111111111111111111111111111111111111111111110010000100001000100010001
100100010001000100010001000000000000000000000000000000000000000000000000000000000000010010000100001000100010001
100100010001000100010001000000000000000000000000000000000000000000000000000000000000010010000100001000100010001
100100010001000100010001000011111111111111111111111111111111111111111111111111111100010010000100001000100010001
100100010001000100010001000010000000000000000000000000000000000000000000000000000100010010000100001000100010001
100100010001000100010001000010000000000000000000000000000000000000000000000000000100010010000100001000100010001
100100010001000100010001000010000111111111111111111111111111111111111111111111000100010010000100001000100010001
100100010001000100010001000010000100000000000000000000000000000000000000000010000100010010000100001000100010001
100100010001000100010001000010000100000000000000000000000000000000000000000010000100010010000100001000100010001
100100010001000100010001000010000100001111111111111111111111111111111111110010000100010010000100001000100010001
100100010001000100010001000010000100001000000000000000000000000000000000010010000100010010000100001000100010001
100100010001000100010001000010000100001000000000000000000000000000000000010010000100010010000100001000100010001
100100010001000100010001000010000100001000011111111111111111111111111100010010000100010010000100001000100010001
100100010001000100010001000010000100001000010000000000000000000000000100010010000100010010000100001000100010001
100100010001000100010001000010000100001000010000000000000000000000000100010010000100010010000100001000100010001
100100010001000100010001000010000100001000010000111111111111111111000100010010000100010010000100001000100010001
100100010001000100010001000010000100001000010000100000000000000010000100010010000100010010000100001000100010001
100100010001000100010001000010000100001000010000100000000000000010000100010010000100010010000100001000100010001
100100010001000100010001000010000100001000010000100011111111110010000100010010000100010010000100001000100010001
100100010001000100010001000010000100001000010000100010000000010010000100010010000100010010000100001000100010001
100100010001000100010001000010000100001000010000100010000000010010000100010010000100010010000100001000100010001
100100010001000100010001000010000100001000010000100010001110010010000100010010000100010010000100001000100010001
100100010001000100010001000010000100001000010000100010001010010010000100010010000100010010000100001000100010001
100100010001000100010001000010000100001000010000100010001010010010000100010010000100010010000100001000100010001
100100010001000100010001000010000100001000010000100010001N10010010000100010010000100010010000100001000100010001
100100010001000100010001000010000100001000010000100010001010010010000100010010000100010010000100001000100010001
100100010001000100010001000010000100001000010000100010001010010010000100010010000100010010000100001000100010001
100100010001000100010001000010000100001000010000100010001110010010000100010010000100010010000100001000100010001
100100010001000100010001000010000100001000010000100010000000010010000100010010000100010010000100001000100010001
100100010001000100010001000010000100001000010000100010000000010010000100010010000100010010000100001000100010001
100100010001000100010001000010000100001000010000100011111111110010000100010010000100010010000100001000100010001
100100010001000100010001000010000100001000010000100000000000000010000100010010000100010010000100001000100010001
100100010001000100010001000010000100001000010000100000000000000010000100010010000100010010000100001000100010001
100100010001000100010001000010000100001000010000111111111111111111000100010010000100010010000100001000100010001
100100010001000100010001000010000100001000010000000000000000000000000100010010000100010010000100001000100010001
100100010001000100010001000010000100001000010000000000000000000000000100010010000100010010000100001000100010001
100100010001000100010001000010000100001000011111111111111111111111110100010010000100010010000100001000100010001
100100010001000100010001000010000100001000000000000000000000000000000000010010000100010010000100001000100010001
100100010001000100010001000010000100001000000000000000000000000000000000010010000100010010000100001000100010001
100100010001000100010001000010000100001111111111111111111111111111111111110010000100010010000100001000100010001
100100010001000100010001000010000100000000000000000000000000000000000000000010000100010010000100001000100010001
100100010001000100010001000010000100000000000000000000000000000000000000000010000100010010000100001000100010001
100100010001000100010001000010000111111111111111111111111111111111111111111110000100010010000100001000100010001
100100010001000100010001000010000000000000000000000000000000000000000000000000000100010010000100001000100010001
100100010001000100010001000010000000000000000000000000000000000000000000000000000100010010000100001000100010001
100100010001000100010001000011111111111111111111111111111111111111111111111111111100010010000100001000100010001
100100010001000100010001000000000000000000000000000000000000000000000000000000000000010010000100001000100010001
100100010001000100010001000000000000000000000000000000000000000000000000000000000000010010000100001000100010001
100100010001000100010001111111111111111111111111111111111111111111111111111111111111110010000100001000100010001
100100010001000100010000000000000000000000000000000000000000000000000000000000000000000010000100001000100010001
100100010001000100010000000000000000000000000000000000000000000000000000000000000000000010000100001000100010001
100100010001000100011111111111111111111111111111111111111111111111111111111111111111111110000100001000100010001
100100010001000100000000000000000000000000000000000000000000000000000000000000000000000000000100001000100010001
100100010001000100000000000000000000000000000000000000000000000000000000000000000000000000000100001000100010001
100100010001000111111111111111111111111111111111111111111111111111111111111111111111111111111100001000100010001
100100010001000000000000000000000000000000000000000000000000000000000000000000000000000000000000001000100010001
100100010001000000000000000000000000000000000000000000000000000000000000000000000000000000000000001000100010001
100100010001111111111111111111111111111111111111111111111111111111111111111111111111111111111111111000100010001
100100010000000000000000000000000000000000000000000000000000000000000000000000000000000000000000000000100010001
100100010000000000000000000000000000000000000000000000000000000000000000000000000000000000000000000000100010001
100100011111111111111111111111111111111111111111111111111111111111111111111111111111111111111111111111100010001
100100000000000000000000000000000000000000000000000000000000000000000000000000000000000000000000000000000010001
100100000000000000000000000000000000000000000000000000000000000000000000000000000000000000000000000000000010001
100111111111111111111111111111111111111111111111111111111111111111111111111111111111111111111111111111111110001
100000000000000000000000000000000000000000000000000000000000000000000000000000000000000000000000000000000000001
100000000000000000000000000000000000000000000000000000000000000000000000000000000000000000000000000000000000001
100000000000000000000000000000000000000000000000000000000000000000000000000000000000000000000000000000000000001
111111111111111111111111111111111111111111111111111111111111111111111111111111111111111111111111111111111111111
