[TILES]

1=wall
N=player
0=floor
2=wall
D=door

[TEXTURES]

1:N=./textures/north.xpm
1:S=./textures/south.xpm
1:E=./textures/east.xpm
1:W=./textures/west.xpm
D=./textures/west.xpm

invalid=./textures/invalid.xpm

[COLORS]

ceiling=0,255,0
floor=255,255,0

[MAP]


1111111111111
111111D111111
111111D111111
111111D111111
111111D111111
111111N111111
1111111111111
