NO ./textures/north.xpm
SO ./textures/south.xpm
WE ./textures/west.xpm
EA ./textures/east.xpm

F 50,50,50
C 20,20,40

1111111111111111111111111111111111111111111111111111111111111111111111111111111111111111111111111111111111111111111111111111111111111111111111111111
1000000000000000000000000000000000000000000000000000000000000000000000000000000000000000000000000000000000000000000000000000000000000000000000001
1010101010101010101010101010101010101010101010101010101010101010101010101010101010101010101010101010101010101010101010101010101010101010101010101
1000001000001000001000001000001000001000001000001000001000001000001000001000001000001000001000001000001000001000001000001000001000001000001000001
1011101011101011101011101011101011101011101011101011101011101011101011101011101011101011101011101011101011101011101011101011101011101011101011101
1010001010001010001010001010001010001010001010001010001010001010001010001010001010001010001010001010001010001010001010001010001010001010001010001
1010111010111010111010111010111010111010111010111010111010111010111010111010111010111010111010111010111010111010111010111010111010111010111010111
1010100010100010100010100010100010100010100010100010100010100010100010100010100010100010100010100010100010100010100010100010100010100010100010101
1010101110101110101110101110101110101110101110101110101110101110101110101110101110101110101110101110101110101110101110101110101110101110101110101
1010101000101000101000101000101000101000101000101000101000101000101000101000101000101000101000101000101000101000101000101000101000101000101000101
1010101010101010101010101010101010101010101010101010101010101010101010101010101010101010101010101010101010101010101010101010101010101010101010101
1010101010001010001010001010001010001010001010001010001010001010001010001010001010001010001010001010001010001010001010001010001010001010001010001
1010101010101010101010101010101010101010101010101010101010101010101010101010101010101010101010101010101010101010101010101010101010101010101010101
1010101010100010100010100010100010100010100010100010100010100010100010100010100010100010100010100010100010100010100010100010100010100010100010001
1010101010101110101110101110101110101110101110101110101110101110101110101110101110101110101110101110101110101110101110101110101110101110101110111
1010101010101000101000101000101000101000101000101000101000101000101000101000101000101000101000101000101000101000101000101000101000101000101000101
1010101010101010101010101010101010101010101010101010101010101010101010101010101010101010101010101010101010101010101010101010101010101010101010101
1000101000101000101000101000101000101000101000101000101000101000101000101000101000101000101000101000101000101000101000101000101000101000101000101
1110101110101110101110101110101110101110101110101110101110101110101110101110101110101110101110101110101110101110101110101110101110101110101110101
1000101000101000101000101000101000101000101000101000101000101000101000101000101000101000101000101000101000101000101000101000101000101000101000101
1010101010101010101010101010101010101010101010101010101010101010101010101010101010101010101010101010101010101010101010101010101010101010101010101
1010001010001010001010001010001010001010001010001010001010001010001010001010001010001010001010001010001010001010001010001010001010001010001010001
1010101010101010101010101010101010101010101010101010101010101010101010101010101010101010101010101010101010101010101010101010101010101010101010101
1010101000101000101000101000101000101000101000101000101000101000101000101000101000101000101000101000101000101000101000101000101000101000101000001
1010101110101110101110101110101110101110101110101110101110101110101110101110101110101110101110101110101110101110101110101110101110101110101110111
1010101010101010101010101010101010101010101010101010101010101010101010101010101010101010101010101010101010101010101010101010101010101010101010101
1000001000001000001000001000001000001000001000001000001000001000001000001000001000001000001000001000001000001000001000001000001000001000001000001
1011101011101011101011101011101011101011101011101011101011101011101011101011101011101011101011101011101011101011101011101011101011101011101011101
1010001010001010001010001010001010001010001010001010001010001010001010001010001010001010001010001010001010001010001010001010001010001010001010001
1010111010111010111010111010111010111010111010111010111010111010111010111010111010111010111010111010111010111010111010111010111010111010111010111
1010100010100010100010100010100010100010100010100010100010100010100010100010100010100010100010100010100010100010100010100010100010100010100010101
1010101110101110101110101110101110101110101110101110101110101110101110101110101110101110101110101110101110101110101110101110101110101110101110101
1010101000101000101000101000101000101000101000101000101000101000101000101000101000101000101000101000101000101000101000101000101000101000101000101
1010101010101010101010101010101010101010101010101010101010101010101010101010101010101010101010101010101010101010101010101010101010101010101010101
1010101010001010001010001010001010001010001010001010001010001010001010001010001010001010001010001010001010001010001010001010001010001010001010001
1010101010101010101010101010101010101010101010101010101010101010101010101010101010101010101010101010101010101010101010101010101010101010101010101
1010101010100010100010100010100010100010100010100010100010100010100010100010100010100010100010100010100010100010100010100010100010100010100010001
1010101010101110101110101110101110101110101110101110101110101110101110101110101110101110101110101110101110101110101110101110101110101110101110111
1010101010101000101000101000101000101000101000101000101000101000101000101000101000101000101000101000101000101000101000101000101000101000101000101
1010101010101010101010101010101010101010101010101010101010101010101010101010101010101010101010101010101010101010101010101010101010101010101010101
1000101000101000101000101000101000101000101000101000101000101000101000101000101000101000101000101000101000101000101000101000101000101000101000101
1110101110101110101110101110101110101110101110101110101110101110101110101110101110101110101110101110101110101110101110101110101110101110101110101
1000101000101000101000101000101000101000101000101000101000101000101000101000101000101000101000101000101000101000101000101000101000101000101000101
1010101010101010101010101010101010101010101010101010101010101010101010101010101010101010101010101010101010101010101010101010101010101010101010101
1010001010001010001010001010001010001010001010001010001010001010001010001010001010001010001010001010001010001010001010001010001010001010001010001
1010101010101010101010101010101010101010101010101010101010101010101010101010101010101010101010101010101010101010101010101010101010101010101010101
1010101000101000101000101000101000101000101000101000101000101000101000101000101000101000101000101000101000101000101000101000101000101000101000001
1010101110101110101110101110101110101110101110101110101110101110101110101110101110101110101110101110101110101110101110101110101110101110101110111
1010101010101010101010101010101010101010101010101010101010101010101010101010101010101010101010101010101010101010101010101010101010101010101010101
1000001000001000001000001000001000001000001000001000001000001000001000001000001000001000001000001000001000001000001000001000001000001000001000001
1011101011101011101011101011101011101011101011101011101011101011101011101011101011101011101011101011101011101011101011101011101011101011101011101
1010001010001010001010001010001010001010001010001010001010001010001010001010001010001010001010001010001010001010001010001010001010001010001010001
1010111010111010111010111010111010111010111010111010111010111010111010111010111010111010111010111010111010111010111010111010111010111010111010111
1010100010100010100010100010100010100010100010100010100010100010100010100010100010100010100010100010100010100010100010100010100010100010100010101
1010101110101110101110101110101110101110101110101110101110101110101110101110101110101110101110101110101110101110101110101110101110101110101110101
1010101000101000101000101000101000101000101000101000101000101000101000101000101000101000101000101000101000101000101000101000101000101000101000101
1010101010101010101010101010101010101010101010101010101010101010101010101010101010101010101010101010101010101010101010101010101010101010101010101
1010101010001010001010001010001010001010001010001010001010001010001010001010001010001010001010001010001010001010001010001010001010001010001010001
1010101010101010101010101010101010101010101010101010101010101010101010101010101010101010101010101010101010101010101010101010101010101010101010101
1010101010100010100010100010100010100010100010100010100010100010100010100010100010100010100010100010100010100010100010100010100010100010100010001
1010101010101110101110101110101110101110101110101110101110101110101110101110101110101110101110101110101110101110101110101110101110101110101110111
1010101010101000101000101000101000101000101000101000101000101000101000101000101000101000101000101000101000101000101000101000101000101000101000101
1010101010101010101010101010101010101010101010101010101010101010101010101010101010101010101010101010101010101010101010101010101010101010101010101
1000101000101000101000101000101000101000101000101000101000101000101000101000101000101000101000101000101000101000101000101000101000101000101000101
1110101110101110101110101110101110101110101110101110101110101110101110101110101110101110101110101110101110101110101110101110101110101110101110101
1000101000101000101000101000101000101000101000101000101000101000101000101000101000101000101000101000101000101000101000101000101000101000101000101
1010101010101010101010101010101010101010101010101010101010101010101010101010101010101010101010101010101010101010101010101010101010101010101010101
1010001010001010001010001010001010001010001010001010001010001010001010001010001010001010001010001010001010001010001010001010001010001010001010001
1010101010101010101010101010101010101010101010101010101010101010101010101010101010101010101010101010101010101010101010101010101010101010101010101
1010101000101000101000101000101000101000101000101000101000101000101000101000101000101000101000101000101000101000101000101000101000101000101000001
1010101110101110101110101110101110101110101110101110101110101110101110101110101110101110101110101110101110101110101110101110101110101110101110111
1010101010101010101010101010101010101010101010101010101010101010101010101010101010101010101010101010101010101010101010101010101010101010101010101
10000010000010000010000010000010000010000010000010000010000010000010000010000010000010000010000010000010000010000010000010000010000010N0001000001
1011101011101011101011101011101011101011101011101011101011101011101011101011101011101011101011101011101011101011101011101011101011101011101011101
1010001010001010001010001010001010001010001010001010001010001010001010001010001010001010001010001010001010001010001010001010001010001010001010001
1010111010111010111010111010111010111010111010111010111010111010111010111010111010111010111010111010111010111010111010111010111010111010111010111
1010100010100010100010100010100010100010100010100010100010100010100010100010100010100010100010100010100010100010100010100010100010100010100010101
1010101110101110101110101110101110101110101110101110101110101110101110101110101110101110101110101110101110101110101110101110101110101110101110101
1010101000101000101000101000101000101000101000101000101000101000101000101000101000101000101000101000101000101000101000101000101000101000101000101
1010101010101010101010101010101010101010101010101010101010101010101010101010101010101010101010101010101010101010101010101010101010101010101010101
1010101010001010001010001010001010001010001010001010001010001010001010001010001010001010001010001010001010001010001010001010001010001010001010001
1010101010101010101010101010101010101010101010101010101010101010101010101010101010101010101010101010101010101010101010101010101010101010101010101
1010101010100010100010100010100010100010100010100010100010100010100010100010100010100010100010100010100010100010100010100010100010100010100010001
1010101010101110101110101110101110101110101110101110101110101110101110101110101110101110101110101110101110101110101110101110101110101110101110111
1010101010101000101000101000101000101000101000101000101000101000101000101000101000101000101000101000101000101000101000101000101000101000101000101
1010101010101010101010101010101010101010101010101010101010101010101010101010101010101010101010101010101010101010101010101010101010101010101010101
1000101000101000101000101000101000101000101000101000101000101000101000101000101000101000101000101000101000101000101000101000101000101000101000101
1110101110101110101110101110101110101110101110101110101110101110101110101110101110101110101110101110101110101110101110101110101110101110101110101
1000101000101000101000101000101000101000101000101000101000101000101000101000101000101000101000101000101000101000101000101000101000101000101000101
1010101010101010101010101010101010101010101010101010101010101010101010101010101010101010101010101010101010101010101010101010101010101010101010101
1010001010001010001010001010001010001010001010001010001010001010001010001010001010001010001010001010001010001010001010001010001010001010001010001
1010101010101010101010101010101010101010101010101010101010101010101010101010101010101010101010101010101010101010101010101010101010101010101010101
1010101000101000101000101000101000101000101000101000101000101000101000101000101000101000101000101000101000101000101000101000101000101000101000001
1010101110101110101110101110101110101110101110101110101110101110101110101110101110101110101110101110101110101110101110101110101110101110101110111
1010101010101010101010101010101010101010101010101010101010101010101010101010101010101010101010101010101010101010101010101010101010101010101010101
1000000000000000000000000000000000000000000000000000000000000000000000000000000000000000000000000000000000000000000000000000000000000000000000001
1111111111111111111111111111111111111111111111111111111111111111111111111111111111111111111111111111111111111111111111111111111111111111111111111
