NO ./textures/north.xpm
SO ./textures/south.xpm
WE ./textures/west.xpm
EA ./textures/east.xpm

F 100,100,100
C 135,206,250

111111111111111111111111111111111111111111111111111
100000000000000000000000000000000000000000000000001
101111111111111111111111111111111111111111111111101
101000000000000000000000000000000000000000000001101
101011111111111111111111111111111111111111111101101
101010000000000000000000000000000000000000000101101
101010111111111111111111111111111111111111110101101
101010100000000000000000000000000000000000010101101
101010101111111111111111111111111111111111010101101
101010101000000000000000000000000000000001010101101
101010101011111111111111111111111111111101010101101
101010101010000000000000000000000000000101010101101
101010101010111111111111111111111111110101010101101
101010101010100000000000000000000000010101010101101
101010101010101111111111111111111111010101010101101
101010101010101000000000000000000001010101010101101
101010101010101011111111111111111101010101010101101
101010101010101010000000000000000101010101010101101
101010101010101010111111111111110101010101010101101
101010101010101010100000000000010101010101010101101
101010101010101010101111111111010101010101010101101
101010101010101010101000000001010101010101010101101
101010101010101010101011111101010101010101010101101
101010101010101010101010000101010101010101010101101
101010101010101010101010110101010101010101010101101
101010101010101010101010N00101010101010101010101101
101010101010101010101010110101010101010101010101101
101010101010101010101010000101010101010101010101101
101010101010101010101011111101010101010101010101101
101010101010101010101000000001010101010101010101101
101010101010101010101111111111010101010101010101101
101010101010101010100000000000010101010101010101101
101010101010101010111111111111110101010101010101101
101010101010101010000000000000000101010101010101101
101010101010101011111111111111111101010101010101101
101010101010101000000000000000000001010101010101101
101010101010101111111111111111111111010101010101101
101010101010100000000000000000000000010101010101101
101010101010111111111111111111111111110101010101101
101010101010000000000000000000000000000101010101101
101010101011111111111111111111111111111101010101101
101010101000000000000000000000000000000001010101101
101010101111111111111111111111111111111111010101101
101010100000000000000000000000000000000000010101101
101010111111111111111111111111111111111111110101101
101010000000000000000000000000000000000000000101101
101011111111111111111111111111111111111111111101101
101000000000000000000000000000000000000000000001101
101111111111111111111111111111111111111111111111101
100000000000000000000000000000000000000000000000001
111111111111111111111111111111111111111111111111111
