[TILES]

1=wall
N=player
0=floor
2=wall
D=door

[TEXTURES]

1:N=./textures/north.xpm
1:S=./textures/south.xpm
1:E=./textures/east.xpm
1:W=./textures/west.xpm
D=./textures/west.xpm

invalid=./textures/invalid.xpm

[COLORS]

ceiling=0,255,0
floor=255,255,0

[MAP]

111111111111111111111
1000000000000000D0001
1D11111111111111111D1
101000000000000000101
10000000000000D000101
10100000D000000000101
101000000000000000101
10000000000D000000101
101000000000000000101
101000000000000000101
101111111111111111101
1000D0000N00000000001
111111111111111111111
