[TILES]

1=wall
N=player
0=floor
2=wall

[TEXTURES]

1:N=./textures/north.xpm
1:S=./textures/south.xpm
1:E=./textures/east.xpm
1:W=./textures/west.xpm

invalid=./textures/invalid.xpm

[COLORS]

ceiling=0,255,0
floor=255,255,0

[MAP]

111111111111111111111
100000000000000000001
101222222222222222101
101               101
101               101
101               101
101               101
101               101
101               101
101               101
101111111111111111101
100000000N00000000001
111111111111111111111
